"Guidelines","Both e-cigarrette and pharmaceutical","Declared none","E-cigarette","No mention","Pharmaceutical","<NA>","Total"
"WHO 2014",2,7,0,3,2,0,14
"WHO 2016",3,13,0,4,2,2,24
"PHE 2015",3,10,1,5,3,0,22
"PHE 2016",1,1,0,0,2,0,4
"PHE 2018",5,11,1,7,4,0,28
"PHE 2019",0,0,0,1,1,0,2
"NICE 2018",1,0,0,0,0,0,1
"PHW 2018",1,0,0,1,1,0,3
"NHMRC 2017",2,12,0,8,1,0,23
"PHAA 2018",0,0,0,1,0,0,1
"SGR 2016",6,21,1,14,3,2,47
"FDA 2016",0,0,0,0,0,0,0
"Total",24,75,3,44,19,4,169
