"Guidelines","Both e-cigarrette and pharmaceutical","Declared none","E-cigarette","No mention","Pharmaceutical","Total"
"WHO 2014",2,7,0,3,2,14
"WHO 2016",3,13,0,4,2,22
"PHE 2015",3,9,1,5,3,21
"PHE 2016",1,1,0,0,2,4
"PHE 2018",5,11,1,7,4,28
"PHE 2019",0,0,0,1,1,2
"NICE 2018",1,0,0,0,0,1
"PHS 2016",0,0,0,1,0,1
"PHW 2017",1,0,0,1,1,3
"NHMRC 2017",2,12,0,8,1,23
"PHAA 2018",0,0,0,1,0,1
"SGR 2016",6,21,1,14,3,45
"FDA 2016",0,0,0,0,0,0
"APHA 2018",2,11,0,4,0,17
"Total",26,85,3,49,19,182
